# -----------------------------------------
# Syntax coloring for TM1638plus library
# -----------------------------------------

# Datatypes (such as objects)
TM1638plus	KEYWORD1
TM1638plus_Model2	KEYWORD1

# Methods / functions
sendCommand	KEYWORD2
sendData	KEYWORD2
reset	KEYWORD2
brightness	KEYWORD2
readButtons	KEYWORD2
setLED	KEYWORD2
displayText	KEYWORD2
displayASCIIwDot	KEYWORD2
displayASCII	KEYWORD2
display7Seg	KEYWORD2
displayHex	KEYWORD2
ReadKey16	KEYWORD2
DisplaySegments		KEYWORD2
DisplayHexNum	KEYWORD2
DisplayDecNum	KEYWORD2
DisplayStr	KEYWORD2
DisplayValues	KEYWORD2

# Constants


